1111111111111111111111111111111111111111
1000100000011000000000000000110000000000
1010101110111011111011111110111111101110
1010001110000010001000000010100010001000
1011111011111110101111111010101010111011
1010000000110000101100001010001000111011
1010111110111011101111101011111111101010
1010001110001011101000001010000011000010
1011101011101010101011111010111011101110
1000001001101010001000100010111000101000
1111111011101010111110101110101110101010
1110000010001010000000100000101000101010
1010111010111010111111111111101011101010
1010100010110011100000000000001011000010
1010101110111011101111111010111011111110
1010100010001000101000001110001000001000
1010111011101110101011101111101111101011
1000011001100010101000100000001110001000
1011111011111010101110111111101010111110
1010000010000010000010000010001010100011
1010111110111111111011111010111010101011
1010001000100000111011100010110010001000
1011101011101110101010101110111011111110
1110001000101110100000101110001010000010
1110111110101010101111101011101010111010
1000100010101000111000001000000010001000
1011101010101011111011111011111111101111
1010001010101000001010001110000000100000
1010111010101111101010101110111010111110
1010111000101000101000100000100010011000
1010101111101010101011111110101111111010
1010100000001110101001100011101000001010
1010111011111110101111101011101011101010
1010000010000000100000101000100010001010
1011111110101110111110101110101110101010
1010000010101100000110100010111000101011
1010111010101111111110101010111011101011
1010111000101000000000111010001011101000
1010101111101011111111111011101010101110
1000000001100000000000000011000010000110
